Explored Nodes: 69
Path Cost: 10
     -     ***---
    ---    B#*---
   ---#######*---
  --------****---
 ---------A------
 ----------------
